00, 00, 00, 00, 00, 00, 00, 00, 00, 00, 00, 00, 00, 00, 00, 00, 00, 00, 00, 00, 00, 00, 00, 00, 00, 00, 00, 00, 00, 00, 00, 00, 00, 00, 00, 00, 00, 00, 00, 00, 00, 00, 00, 00, 00, 00, 00, 00, 00, 00, 
00, 00, 00, 00, 00, 00, 00, 00, 00, 00, 00, 00, 00, 00, 00, 00, 00, 00, 00, 00, 00, 00, 00, 00, 00, 00, 00, 00, 00, 00, 00, 00, 00, 00, 00, 00, 00, 00, 00, 00, 00, 00, 00, 00, 00, 00, 00, 00, 00, 00, 
00, 00, 00, 00, 00, 00, 00, 00, 00, 00, 00, 00, 00, 00, 00, 00, 00, 00, 00, 00, 00, 00, 00, 00, 00, 00, 00, 00, 00, 00, 00, 00, 00, 00, 00, 00, 00, 00, 00, 00, 00, 00, 00, 00, 00, 00, 00, 00, 00, 00, 
00, 00, 00, 00, 00, 00, 00, 00, 00, 00, 00, 00, 00, 00, 00, 00, 00, 00, 00, 00, 00, 00, 00, 00, 00, 00, 00, 00, 00, 00, 00, 00, 00, 00, 00, 00, 00, 00, 00, 00, 00, 00, 00, 00, 00, 00, 00, 00, 00, 00, 
00, 00, 00, 00, 00, 00, 00, 00, 00, 00, 00, 00, 00, 00, 00, 00, 00, 00, 00, 00, 00, 00, 00, 00, 00, 00, 00, 00, 00, 00, 00, 00, 00, 00, 00, 00, 00, 00, 00, 00, 00, 00, 00, 00, 00, 00, 00, 00, 00, 00, 
00, 00, 00, 00, 00, 00, 00, 00, 00, 00, 00, 00, 00, 00, 00, 00, 00, 00, 00, 00, 00, 00, 00, 00, 00, 00, 00, 00, 00, 00, 00, 00, 00, 00, 00, 00, 00, 00, 00, 00, 00, 00, 00, 00, 00, 00, 00, 00, 00, 00, 
00, 00, 00, 00, 00, 00, 00, 00, 00, 00, 00, 00, 00, 00, 00, 00, 00, 00, 00, 00, 00, 00, 00, 00, 00, 00, 00, 00, 00, 00, 00, 00, 00, 00, 00, 00, 00, 00, 00, 00, 00, 00, 00, 00, 00, 00, 00, 00, 00, 00, 
00, 00, 00, 00, 00, 00, 00, 00, 00, 00, 00, 00, 00, 00, 00, 00, 00, 00, 00, 00, 00, 00, 00, 00, 00, 00, 00, 00, 00, 00, 00, 00, 00, 00, 00, 00, 00, 00, 00, 00, 00, 00, 00, 00, 00, 00, 00, 00, 00, 00, 
00, 00, 00, 00, 00, 00, 00, 00, 00, 00, 00, 00, 00, 00, 00, 00, 00, 00, 00, 00, 00, 00, 00, 00, 00, 00, 00, 00, 00, 00, 00, 00, 00, 00, 00, 00, 00, 00, 00, 00, 00, 00, 00, 00, 00, 00, 00, 00, 00, 00, 
00, 00, 00, 00, 00, 00, 00, 00, 00, 00, 00, 00, 00, 00, 00, 00, 00, 00, 00, 00, 00, 00, 00, 00, 00, 00, 00, 00, 00, 00, 00, 00, 00, 00, 00, 00, 00, 00, 00, 00, 00, 00, 00, 00, 00, 00, 00, 00, 00, 00, 
00, 00, 00, 00, 00, 00, 00, 00, 00, 00, 00, 00, 00, 00, 00, 00, 00, 00, 00, 00, 10, 04, 04, 04, 04, 04, 04, 04, 04, 11, 00, 00, 00, 00, 00, 00, 00, 00, 00, 00, 00, 00, 00, 00, 00, 00, 00, 00, 00, 00, 
00, 00, 00, 00, 00, 00, 00, 00, 00, 00, 00, 00, 00, 00, 00, 00, 00, 00, 00, 00, 02, 01, 01, 01, 01, 01, 01, 01, 01, 03, 00, 00, 00, 00, 00, 00, 00, 00, 00, 00, 00, 00, 00, 00, 00, 00, 00, 00, 00, 00, 
00, 00, 00, 00, 00, 00, 00, 00, 00, 00, 00, 00, 00, 00, 00, 00, 00, 00, 00, 00, 02, 01, 01, 01, 01, 01, 01, 01, 01, 03, 00, 00, 00, 00, 00, 00, 00, 00, 00, 00, 00, 00, 00, 00, 00, 00, 00, 00, 00, 00, 
00, 00, 00, 00, 00, 00, 00, 00, 00, 00, 00, 00, 00, 00, 00, 00, 00, 00, 00, 00, 02, 01, 01, 01, 01, 01, 01, 01, 01, 03, 00, 00, 00, 00, 00, 00, 00, 00, 00, 00, 00, 00, 00, 00, 00, 00, 00, 00, 00, 00, 
00, 00, 00, 00, 00, 00, 00, 00, 00, 00, 00, 00, 00, 00, 00, 00, 00, 00, 00, 00, 02, 01, 01, 01, 01, 01, 01, 01, 01, 03, 00, 00, 00, 00, 00, 00, 00, 00, 00, 00, 00, 00, 00, 00, 00, 00, 00, 00, 00, 00, 
00, 00, 00, 00, 00, 00, 00, 00, 00, 00, 00, 00, 00, 00, 00, 00, 00, 00, 00, 00, 02, 01, 01, 01, 01, 01, 01, 01, 01, 03, 00, 00, 00, 00, 00, 00, 00, 00, 00, 00, 00, 00, 00, 00, 00, 00, 00, 00, 00, 00, 
00, 00, 00, 00, 00, 00, 00, 00, 00, 00, 00, 00, 00, 00, 00, 00, 00, 00, 00, 00, 02, 01, 01, 01, 01, 01, 01, 01, 01, 03, 00, 00, 00, 00, 00, 00, 00, 00, 00, 00, 00, 00, 00, 00, 00, 00, 00, 00, 00, 00, 
00, 00, 00, 00, 00, 00, 00, 00, 00, 00, 00, 00, 00, 00, 00, 00, 00, 00, 00, 00, 02, 01, 01, 01, 01, 01, 01, 01, 01, 03, 00, 00, 00, 00, 00, 00, 00, 00, 00, 00, 00, 00, 00, 00, 00, 00, 00, 00, 00, 00, 
00, 00, 00, 00, 00, 00, 00, 00, 00, 10, 11, 00, 00, 00, 00, 00, 00, 00, 00, 00, 02, 01, 01, 01, 01, 01, 01, 01, 01, 03, 00, 00, 00, 00, 00, 00, 00, 00, 00, 00, 00, 00, 00, 00, 00, 00, 00, 00, 00, 00, 
00, 00, 00, 00, 00, 00, 00, 00, 00, 02, 03, 00, 00, 00, 00, 00, 00, 00, 00, 00, 13, 05, 05, 07, 01, 01, 06, 05, 05, 12, 00, 00, 00, 00, 00, 00, 00, 00, 00, 00, 00, 00, 00, 00, 00, 00, 00, 00, 00, 00, 
00, 00, 00, 00, 00, 00, 00, 00, 00, 02, 03, 00, 00, 00, 00, 00, 00, 00, 00, 00, 00, 00, 00, 02, 01, 01, 03, 00, 00, 00, 00, 00, 00, 00, 00, 00, 00, 00, 00, 00, 00, 00, 00, 00, 00, 00, 00, 00, 00, 00, 
00, 00, 00, 00, 00, 00, 00, 00, 00, 02, 03, 00, 00, 00, 00, 00, 00, 00, 00, 00, 00, 00, 00, 02, 01, 01, 03, 00, 00, 00, 00, 00, 00, 00, 00, 00, 00, 00, 00, 00, 00, 00, 00, 00, 00, 00, 00, 00, 00, 00, 
00, 00, 00, 00, 00, 00, 00, 00, 00, 02, 03, 00, 00, 00, 00, 00, 00, 00, 00, 00, 00, 00, 00, 02, 01, 01, 03, 00, 00, 00, 00, 00, 00, 00, 00, 00, 00, 00, 00, 00, 00, 00, 00, 00, 00, 00, 00, 00, 00, 00, 
00, 00, 00, 00, 00, 00, 00, 00, 00, 02, 03, 00, 00, 00, 00, 00, 00, 00, 00, 00, 00, 00, 00, 02, 01, 01, 03, 00, 00, 00, 00, 00, 00, 00, 00, 00, 00, 00, 00, 00, 00, 00, 00, 00, 00, 00, 00, 00, 00, 00, 
00, 00, 00, 00, 00, 00, 00, 00, 00, 02, 03, 00, 00, 00, 00, 00, 00, 00, 00, 00, 00, 00, 00, 02, 01, 01, 03, 00, 00, 00, 00, 00, 00, 00, 00, 00, 00, 00, 00, 00, 00, 00, 00, 00, 00, 00, 00, 00, 00, 00, 
00, 00, 00, 00, 00, 00, 00, 00, 00, 02, 03, 00, 00, 00, 00, 00, 00, 00, 00, 00, 00, 00, 00, 02, 01, 01, 03, 00, 00, 00, 00, 00, 00, 00, 00, 00, 00, 00, 00, 00, 00, 00, 00, 00, 00, 00, 00, 00, 00, 00, 
00, 00, 00, 00, 00, 00, 00, 00, 00, 02, 03, 00, 00, 00, 00, 00, 00, 00, 00, 00, 00, 00, 00, 02, 01, 01, 03, 00, 00, 00, 00, 00, 00, 00, 00, 00, 00, 00, 00, 00, 00, 00, 00, 00, 00, 00, 00, 00, 00, 00, 
00, 00, 00, 00, 00, 00, 00, 00, 00, 02, 03, 00, 00, 00, 00, 00, 00, 00, 00, 00, 00, 00, 00, 02, 01, 01, 03, 00, 00, 00, 00, 00, 00, 00, 00, 00, 00, 00, 00, 00, 00, 00, 00, 00, 00, 00, 00, 00, 00, 00, 
00, 00, 00, 00, 00, 00, 00, 00, 00, 02, 03, 00, 00, 00, 00, 00, 00, 00, 00, 00, 00, 00, 00, 02, 01, 01, 03, 00, 00, 00, 00, 00, 00, 00, 00, 00, 00, 00, 00, 00, 00, 00, 00, 00, 00, 00, 00, 00, 00, 00, 
00, 00, 00, 00, 00, 00, 00, 00, 00, 02, 03, 00, 00, 00, 00, 00, 00, 00, 00, 00, 00, 00, 00, 02, 01, 01, 03, 00, 00, 00, 00, 00, 00, 00, 00, 00, 00, 00, 00, 00, 00, 00, 00, 00, 00, 00, 00, 00, 00, 00, 
00, 00, 00, 00, 00, 00, 00, 00, 00, 02, 03, 00, 00, 00, 00, 00, 00, 00, 00, 00, 00, 00, 00, 02, 01, 01, 03, 00, 00, 00, 00, 00, 00, 00, 00, 00, 00, 00, 00, 00, 00, 00, 00, 00, 00, 00, 00, 00, 00, 00, 
00, 00, 00, 00, 00, 00, 00, 00, 00, 02, 03, 00, 00, 00, 00, 00, 00, 00, 00, 00, 00, 00, 00, 02, 01, 01, 03, 00, 00, 00, 00, 00, 00, 00, 00, 00, 00, 00, 00, 00, 00, 00, 00, 00, 00, 00, 00, 00, 00, 00, 
00, 00, 00, 00, 00, 00, 00, 00, 00, 02, 03, 00, 00, 00, 00, 00, 00, 00, 00, 00, 00, 00, 00, 02, 01, 01, 03, 00, 00, 00, 00, 00, 00, 00, 00, 00, 00, 00, 00, 00, 00, 00, 00, 00, 00, 00, 00, 00, 00, 00, 
00, 00, 00, 00, 00, 00, 00, 00, 00, 02, 03, 00, 00, 00, 00, 00, 00, 00, 00, 00, 00, 00, 00, 02, 01, 01, 03, 00, 00, 00, 00, 00, 00, 00, 00, 00, 00, 00, 00, 00, 00, 00, 00, 00, 00, 00, 00, 00, 00, 00, 
00, 00, 00, 00, 00, 00, 00, 00, 00, 02, 09, 04, 04, 04, 04, 04, 04, 04, 04, 04, 04, 04, 04, 08, 01, 01, 09, 04, 04, 04, 04, 04, 04, 04, 04, 04, 04, 04, 04, 04, 04, 11, 00, 00, 00, 00, 00, 00, 00, 00, 
00, 00, 00, 00, 00, 00, 00, 00, 00, 02, 06, 05, 05, 05, 05, 05, 05, 05, 05, 05, 05, 05, 05, 07, 01, 01, 06, 05, 05, 05, 05, 05, 05, 05, 05, 05, 05, 05, 05, 05, 05, 12, 00, 00, 00, 00, 00, 00, 00, 00, 
00, 00, 00, 00, 00, 00, 00, 00, 00, 02, 03, 00, 00, 00, 00, 00, 00, 00, 00, 00, 00, 00, 00, 02, 01, 01, 03, 00, 00, 00, 00, 00, 00, 00, 00, 00, 00, 00, 00, 00, 00, 00, 00, 00, 00, 00, 00, 00, 00, 00, 
00, 00, 00, 00, 00, 00, 00, 00, 00, 02, 03, 00, 00, 00, 00, 00, 00, 00, 00, 00, 00, 00, 00, 02, 01, 01, 03, 00, 00, 00, 00, 00, 00, 00, 00, 00, 00, 00, 00, 00, 00, 00, 00, 00, 00, 00, 00, 00, 00, 00, 
00, 00, 00, 00, 00, 00, 00, 00, 00, 02, 03, 00, 00, 00, 00, 00, 00, 00, 00, 00, 00, 00, 00, 02, 01, 01, 03, 00, 00, 00, 00, 00, 00, 00, 00, 00, 00, 00, 00, 00, 00, 00, 00, 00, 00, 00, 00, 00, 00, 00, 
00, 00, 00, 00, 00, 00, 00, 00, 00, 02, 03, 00, 00, 00, 00, 00, 00, 00, 00, 00, 00, 00, 00, 02, 01, 01, 03, 00, 00, 00, 00, 00, 00, 00, 00, 00, 00, 00, 00, 00, 00, 00, 00, 00, 00, 00, 00, 00, 00, 00, 
00, 00, 00, 00, 00, 00, 00, 00, 00, 02, 03, 00, 00, 00, 00, 00, 00, 00, 00, 00, 00, 00, 00, 02, 01, 01, 03, 00, 00, 00, 00, 00, 00, 00, 00, 00, 00, 00, 00, 00, 00, 00, 00, 00, 00, 00, 00, 00, 00, 00, 
00, 00, 00, 00, 00, 00, 00, 00, 00, 02, 03, 00, 00, 00, 00, 00, 00, 00, 00, 00, 00, 00, 00, 02, 01, 01, 03, 00, 00, 00, 00, 00, 00, 00, 00, 00, 00, 00, 00, 00, 00, 00, 00, 00, 00, 00, 00, 00, 00, 00, 
00, 00, 00, 00, 00, 00, 00, 00, 00, 02, 03, 00, 00, 00, 00, 00, 00, 00, 00, 00, 00, 00, 00, 02, 01, 01, 03, 00, 00, 00, 00, 00, 00, 00, 00, 00, 00, 00, 00, 00, 00, 00, 00, 00, 00, 00, 00, 00, 00, 00, 
00, 00, 00, 00, 00, 00, 00, 00, 00, 02, 03, 00, 00, 00, 00, 00, 00, 00, 00, 00, 00, 00, 00, 02, 01, 01, 03, 00, 00, 00, 00, 00, 00, 00, 00, 00, 00, 00, 00, 00, 00, 00, 00, 00, 00, 00, 00, 00, 00, 00, 
00, 00, 00, 00, 00, 00, 00, 00, 00, 02, 03, 00, 00, 00, 00, 00, 00, 00, 00, 00, 00, 00, 00, 02, 01, 01, 03, 00, 00, 00, 00, 00, 00, 00, 00, 00, 00, 00, 00, 00, 00, 00, 00, 00, 00, 00, 00, 00, 00, 00, 
00, 00, 00, 00, 00, 00, 00, 00, 00, 13, 12, 00, 00, 00, 00, 00, 00, 00, 00, 00, 00, 00, 00, 02, 01, 01, 03, 00, 00, 00, 00, 00, 00, 00, 00, 00, 00, 00, 00, 00, 00, 00, 00, 00, 00, 00, 00, 00, 00, 00, 
00, 00, 00, 00, 00, 00, 00, 00, 00, 00, 00, 00, 00, 00, 00, 00, 00, 00, 00, 00, 00, 00, 00, 02, 01, 01, 03, 00, 00, 00, 00, 00, 00, 00, 00, 00, 00, 00, 00, 00, 00, 00, 00, 00, 00, 00, 00, 00, 00, 00, 
00, 00, 00, 00, 00, 00, 00, 00, 00, 00, 00, 00, 00, 00, 00, 00, 00, 00, 00, 00, 00, 00, 00, 02, 01, 01, 03, 00, 00, 00, 00, 00, 00, 00, 00, 00, 00, 00, 00, 00, 00, 00, 00, 00, 00, 00, 00, 00, 00, 00, 
00, 00, 00, 00, 00, 00, 00, 00, 00, 00, 00, 00, 00, 00, 00, 00, 00, 00, 00, 00, 00, 00, 00, 02, 01, 01, 03, 00, 00, 00, 00, 00, 00, 00, 00, 00, 00, 00, 00, 00, 00, 00, 00, 00, 00, 00, 00, 00, 00, 00, 
00, 00, 00, 00, 00, 00, 00, 00, 00, 00, 00, 00, 00, 00, 00, 00, 00, 00, 00, 00, 00, 00, 00, 02, 01, 01, 03, 00, 00, 00, 00, 00, 00, 00, 00, 00, 00, 00, 00, 00, 00, 00, 00, 00, 00, 00, 00, 00, 00, 00, 
